
HDN = "countries/Hyperdimension Neptunia.txt"
TOB = "countries/Tales of Berseria.txt"
F13 = "countries/Final Fantasy 13.txt"
SAO = "countries/Sword Art Online.txt"
LL1 = "countries/Love Live.txt"
GDM = "countries/Gundam.txt"
VVL = "countries/Kakumeiki Valvrave.txt"
LH0 = "countries/Love Hina.txt"
OMG = "countries/Aa! Megami-sama!.txt"
FEF = "countries/Fire Emblem Fates.txt"
XNS = "countries/Xenosaga.txt"
XB1 = "countries/Xenoblade 1.txt"
XB2 = "countries/Xenoblade 2.txt"
XBX = "countries/Xenoblade X.txt"
VC1 = "countries/valkyria chronicles 1.txt"
VC4 = "countries/valkyria chronicles 1.txt"
EVA = "countries/Neon Genesis Evangelion.txt"
HI3 = "countries/Honkai Impact 3rd.txt"
GI0 = "countries/Genshin Impact.txt"
TGL = "countries/Tengen Toppa Gurren Lagann.txt"
KTC = "countries/Kantai Collection.txt"
AZL = "countries/Azur Lane.txt"
FT0 = "countries/Fairy Tail.txt"
FEA = "countries/Fire Emblem Awakening.txt"
FET = "countries/Fire Emblem Three Houses.txt"
NAM = "countries/Nier Automata.txt"
HLS = "countries/Hellsing.txt"
MCR = "countries/Hellsing.txt"
GBS = "countries/Goblin Slayer.txt"
PS5 = "countries/Persona 5.txt"
RNM = "countries/Ranma.txt"
KMD = "countries/Kobayashi-san Chi No Maid Dragon.txt"
SLM = "countries/Tensei shitara Slime Datta Ken.txt"
FMP = "countries/Full Metal Panic.txt"
CDG = "countries/Code Geass.txt"
GBF = "countries/Granblue Fantasy.txt"
ISA = "countries/Irozuku Sekai no Ashita kara.txt"
NGL = "countries/No Game No Life.txt"
OTN = "countries/Ore, Twintail ni Narimasu.txt"
STB = "countries/Strike the Blood.txt"
KSB = "countries/Kono Subarashii Sekai ni Shukufuku wo.txt"
TMS = "countries/Tokyo Mirage Sessions.txt"
DSG = "countries/Disgaea.txt"
LGS = "countries/Langrisser.txt"
TOX = "countries/Tales of Xillia.txt"
ARP = "countries/Arpeggio of Blue Steel.txt"
AGA = "countries/Agent Aika.txt"
SLR = "countries/Slayers.txt"
DXD = "countries/High School DxD.txt"
ICG = "countries/The iDOLMASTER Cinderella Girls.txt"
IMR = "countries/The iDOLMASTER.txt"
BDC = "countries/Blood-C.txt"
MSM = "countries/Mahou Shoujo Madoka Magica.txt"
MSN = "countries/Mahou Shoujo Lyrical Nanoha.txt"
SHY = "countries/Suzumiya Haruhi no Yuuutsu.txt"
WAT = "countries/Watashi ga Motenai no wa Dou Kangaetemo Omaera ga Warui.txt"
HSD = "countries/Highschool of the Dead.txt"
MRO = "countries/Mario.txt"
ZZZ = "countries/Mario.txt"
TMN = "countries/Taimanin.txt"
PCP = "countries/Princess Principal.txt"
SNH = "countries/Shining Hearts.txt"
ALR = "countries/Atelier Ryza.txt"
STW = "countries/Shining Tears X Wind.txt"
TTT = "countries/Tears to Tiara.txt"
ZNT = "countries/Zero no Tsukaima.txt"
DGD = "countries/Dog Days.txt"
F10 = "countries/Final Fantasy 10.txt"
F12 = "countries/Final Fantasy 12.txt"
F15 = "countries/Final Fantasy 15.txt"
FF7 = "countries/Final Fantasy 7.txt"
FF8 = "countries/Final Fantasy 8.txt"
GUP = "countries/Girls und Panzer.txt"
HSF = "countries/High School Fleet.txt"
MAT = "countries/Muv-Luv Alternative.txt"
NGM = "countries/New Game.txt"
SWC = "countries/Strike Witches.txt"
BDP = "countries/Blood plus.txt"
CYM = "countries/Claymore.txt"
DNT = "countries/Druaga no Tou.txt"
EFL = "countries/Elfen Lied.txt"
FF9 = "countries/Final Fantasy 9.txt"
GCS = "countries/Grancrest Senki.txt"
MSL = "countries/Mahou Senshi Louie.txt"
MRN = "countries/Mirai Nikki.txt"
ONI = "countries/Oni.txt"
RAW = "countries/Record of Agarest War.txt"
RLW = "countries/Record of Lodoss War.txt"
SBH = "countries/Shikabane Hime.txt"
TOG = "countries/Tales of Graces.txt"
TOS = "countries/Tales of Symphonia.txt"
TOV = "countries/Tales of Vesperia.txt"
TNE = "countries/Tenkuu no Escaflowne.txt"
UWM = "countries/Utawarerumono.txt"
VC2 = "countries/Valkyria chronicles 2.txt"
VC3 = "countries/Valkyria chronicles 3.txt"
ALA = "countries/Atelier Arland.txt"
ALD = "countries/Atelier Dusk.txt"
ALS = "countries/Atelier Sophie.txt"
DNM = "countries/Dungeon ni Deai wo Motomeru no wa Machigatteiru Darou ka.txt"
FEE = "countries/Fire Emblem Echoes.txt"
FGO = "countries/Fate Grand Order.txt"
FSN = "countries/Fate Stay Night.txt"
FTA = "countries/Fate Apocrypha.txt"
FTI = "countries/Fate Illya.txt"
FZG = "countries/Freezing.txt"
HMS = "countries/Hataraku Maou-sama.txt"
IUD = "countries/Ichiban Ushiro no Daimaou.txt"
MAI = "countries/Mai-Otome.txt"
MMY = "countries/Maoyuu Maou Yuusha.txt"
NOA = "countries/Nights of Azure.txt"
STO = "countries/Star Ocean.txt"
YNO = "countries/Yuusha ni Narenakatta.txt"
ACW = "countries/Accel World.txt"
GAT = "countries/Gate.txt"
IMS = "countries/Isekai Maou to Shoukan Shoujo no Dorei Majutsu.txt"
IUC = "countries/Infinite Undiscovery.txt"
LHZ = "countries/Log Horizon.txt"
MSR = "countries/Maou-sama Retry.txt"
OTK = "countries/Ookami to Koushinryou.txt"
OVL = "countries/Overlord.txt"
REC = "countries/Re Creators.txt"
SDK = "countries/Sudeki.txt"
SMT = "countries/Shinmai Maou no Testament.txt"
SNM = "countries/Seikai no Monshou.txt"
DGB = "countries/Dragon Ball.txt"
DOA = "countries/Dead or Alive.txt"
TOA = "countries/Tales of the Abyss.txt"